1111111111111111111
101000000C000000E11
1010000000000000001
1100000000000000001
10000C0C0C0C0000001
10000C0C0C0C0000001
10000C0C0C0C0000001
10000C0C0C0C0000001
10000C0C0P000000001
10000C0C0C0C0000011
10000C0C0C0C0001111
1111111111111111111